0  0  0  0  0  0  0  0  0  1  1  1  1  1  1  1
0  0  0  0  0  0  0  0  0  1  1  1  1  1  1  1
0  7  0  0  0  0  0  0  0  0  0  0  0  0  0  0
0  3  0  0  0  0  0  0  0  0  0  0  0  0  0  0
0  4  0  0  12 0  0  0  0  0  0  0  0  0  0  0
0  5  0  0  0  0  0  0  0  0  0  0  0  0  0  0
0  6  0  0  0  0  0  0  0  0  0  0  0  0  0  0
0  0  11 2  8  9  0  10 0  0  0  0  0  0  0  0
0  0  0  0  0  0  0  0  0  0  0  0  0  0  0  0